

SE 898 08098 08098

11111111111
00000111100
10010922222